1111111111111111111111111111111111111111
1P010000010000000000000000000000000000C1
1001000001000000000000000000000000000001
1001001001001001111111111111111111111111
1000001001001001C00000000000000000000001
1000001000001001000000000000000000000001
1111111000001001000000000111111111111001
1000000001001001000000000100100000001001
1000000001001001000000000100100000001001
1001111111001001000000000100100100001001
1001X000X1001001C000E000C10010010X001001
100100C001001001000000000100100100001001
1001000001001001X000C000X100100100001001
100100C00100100111111111110010010C001001
1001000001001000000000000000100100001001
1001000001001C0000000000000C10010X001001
1001111001001111111111111111100100001001
1000000001000000000000000000000100000001
1000000001000000000000000000000100000001
1111111111111111111111111111111111111111
